

NO               ./path_to_the_north_texture


SO               ./path_to_the_south_texture





F 220,100,0




WE ./path_to_the_west_texture
EA ./path_to_the_east_texture

C 225,30,0

111111111
1001 1001
100111001
1N0000001
111111111
101111111
11111111
