

NO               ./textures/wall1.xpm


SO               ./textures/wall2.xpm

SO               ./textures/wall2.xpm



F 169,169,169





WE ./textures/wall3.xpm
EA ./textures/wall4.xpm

C 135,206,235

1111111111111111111111111111111111
1000000000000000000000000000000001
1000000000000000000000000000000001
1000000000000000000000000000000001
1000000000000000000000000000000001
1000000000000000000000000000000001
1111111110000000001111111111111111
1000000000000000000000000000000001
1000000000000000000000000000000001
1000000000000000000000000000000001
1000000000000000000000000000000001
1000000000000000000000000000000001
1100000000000000000011111111111111
100000000000000000001
100000000000000000001
1000000000000000000S1
111111111111111111111
