

NO               ./textures/wall1.xpm


SO               ./textures/wall4.xpm





F 220,100,0




WE ./textures/wall3.xpm
EA ./textures/wall2.xpm

C 225,30,0

11111111111111111111111
10000000000000000000001
10000000100000000000001
10000000112111111111111
1000000000001
1000000000001
10000000000W1
1111111111111
