

NO               ./path_to_the_north_texture


SO               ./path_to_the_south_texture





F 220,100,0




WE ./path_to_the_west_texture
EA ./path_to_the_east_texture

C 225,30,0

1111111111111
1000000000001
1000000000001
1000000000001
1000000000001
1000000000001
10000000000W1
1111111111111
