

NO               ./textures/wall1.xpm


SO               ./textures/wall2.xpm





F 50,50,50


WE  ./textures/wall3.xpm

EA ./textures/wall4.xpm

C 0,87,173

1111111111
1N00000001
1111111101
1111111101111111
11111111011   1
111100000111111
1111011111110011
1111011111111111
11110111
1111011111111111
1111011111111111
1111011111111111
1111011111111111
1111011111111111
1111011111111111
1111011111111111
1111011111111111
1111011111111111
1111011111111111
1111011111111111
1111011111111111
1111011111111111
1111011111111111
1111011111111111
1111011111111111
1111011111111111
111101111111111111111111111111111111111111111111111
1010001000000000001000000000001000000000000000001
11000001000000000000000000000000001000100000000001
10010000000000010000000000001000000000000000001001
10000000000000000000000000000000000000000000000001
100000000100000000000001000000000000010000000010001
10010000000000000000000000000000000010000000000001
10000000000000010000000000010000000010000000000001
1111111111111111111111111111111111111111111111111111111
