
NO               ./path_to_the_north_texture
SO  ./path_to_the_south_texture
WE     ./path_to_the_west_texture
EA  ./path_to_the_east_texture

F 220,100,0
C 225,30,0











1                        1
11                      11
111                    111
1111                  1111
11111                11111
111111              111111
1111111            1111111
11111111          11111111
111111111        111111111
10000000111111111100000011111
111100S000000011100000000011
111111110000000101111100101011
111111111111111111111111111111
