

NO               ./path_to_the_north_texture


SO               ./path_to_the_south_texture





F 220,100,0




WE ./path_to_the_west_texture
EA ./path_to_the_east_texture

C 225,30,0

111111111111111
1000000 1100001
10N000011111111
111111111111011
